00 02 00 00 00 00 00 02 00 00 02 00 00 00 00
02 00 00 00 02 04 00 00 00 00 00 00 00 00 00 
00 02 03 00 01 03 00 00 00 00 00 00 00 00 00 
00 01 03 03 03 05 03 03 03 03 03 00 01 00 00
02 00 00 08 08 05 00 08 08 00 00 00 06 00 00 
00 02 05 05 05 00 05 05 05 05 05 04 00 00 00 
00 00 06 00 00 00 00 00 00 00 00 00 00 00 00 
00 00 06 00 00 00 00 00 00 00 00 00 00 00 00
00 01 05 05 05 05 05 05 05 05 05 03 00 00 00
00 00 06 00 00 00 00 00 00 00 00 00 00 00 00
00 00 06 00 00 00 00 00 00 00 00 00 00 00 00
00 00 06 00 00 00 00 00 00 00 00 00 00 00 00
00 00 06 00 00 00 00 00 00 00 00 00 00 00 00 
00 00 06 00 00 00 00 00 00 00 00 00 00 00 00
00 00 06 00 00 00 00 00 00 00 00 00 00 00 00