{
  "tiles": [
    [ 0, 2, 0, 0, 0, 0, 0, 2, 0, 0, 2, 0, 0, 0, 0 ],
    [ 2, 0, 0, 0, 2, 4, 0, 0, 0, 0, 0, 0, 0, 0, 0 ],
    [ 0, 2, 3, 0, 1, 3, 0, 0, 0, 0, 0, 0, 0, 0, 0 ],
    [ 0, 2, 0, 0, 0, 0, 0, 2, 0, 0, 2, 0, 0, 0, 0 ],
    [ 2, 0, 0, 0, 2, 4, 0, 0, 0, 0, 0, 0, 0, 0, 0 ],
    [ 0, 2, 3, 0, 1, 3, 0, 0, 0, 0, 0, 0, 0, 0, 0 ],
    [ 0, 2, 0, 0, 0, 0, 0, 2, 0, 0, 2, 0, 0, 0, 0 ],
    [ 2, 0, 0, 0, 2, 4, 0, 0, 0, 0, 0, 0, 0, 0, 0 ],
    [ 0, 2, 3, 0, 1, 3, 0, 0, 0, 0, 0, 0, 0, 0, 0 ],
    [ 0, 2, 0, 0, 0, 0, 0, 2, 0, 0, 2, 0, 0, 0, 0 ],
    [ 2, 0, 0, 0, 2, 4, 0, 0, 0, 0, 0, 0, 0, 0, 0 ],
    [ 0, 2, 3, 0, 1, 3, 0, 0, 0, 0, 0, 0, 0, 0, 0 ],
    [ 0, 2, 0, 0, 0, 0, 0, 2, 0, 0, 2, 0, 0, 0, 0 ],
    [ 2, 0, 0, 0, 2, 4, 0, 0, 0, 0, 0, 0, 0, 0, 0 ],
    [ 0, 2, 3, 0, 1, 3, 0, 0, 0, 0, 0, 0, 0, 0, 0 ]
  ],

  "height": 495,

  "width": 495


}