00 00 02 00 00 00 00 00 02 00 00 02 00 00 00 00
00 02 00 00 00 00 00 00 00 00 00 00 00 00 00 00
00 00 02 03 03 03 03 03 03 03 03 03 04 00 00 00
00 00 01 03 03 03 03 03 03 03 03 03 05 01 00 00
00 02 00 00 08 08 08 08 08 08 00 00 00 06 00 00
00 00 00 06 00 00 00 00 00 00 00 00 00 00 00 00
00 00 00 06 00 00 00 00 00 00 00 00 00 00 00 00
