{
  "tiles": [
    [ 0, 0, 0, 0, 0, 0, 0, 0, 0, 0, 0, 0, 0, 0, 0, 0, 0 ],
    [ 0, 2, 6, 6, 6, 6, 6, 6, 6, 6, 6, 6, 6, 10, 6, 4, 0 ],
    [ 0, 11, 0, 0, 0, 0, 0, 0, 0, 0, 0, 0, 0, 0, 0, 8, 0 ],
    [ 0, 7, 0, 0, 0, 0, 0, 0, 0, 0, 0, 0, 0, 0, 0, 8, 0 ],
    [ 0, 7, 0, 0, 0, 0, 0, 0, 0, 0, 0, 0, 0, 0, 0, 8, 0 ],
    [ 0, 7, 0, 0, 0, 0, 0, 0, 0, 0, 0, 0, 0, 0, 0, 14, 0 ],
    [ 0, 7, 0, 0, 0, 0, 0, 0, 0, 0, 0, 0, 0, 0, 0, 8, 0 ],
    [ 0, 7, 0, 0, 0, 0, 0, 0, 0, 0, 0, 0, 0, 0, 0, 8, 0 ],
    [ 0, 7, 0, 0, 0, 0, 0, 0, 0, 0, 0, 0, 0, 0, 0, 8, 0 ],
    [ 0, 7, 0, 0, 0, 0, 0, 0, 0, 0, 0, 0, 0, 0, 0, 12, 0 ],
    [ 0, 1, 5, 5, 5, 5, 5, 9, 5, 5, 5, 5, 5, 5, 5, 3, 0 ],
    [ 0, 0, 0, 0, 0, 0, 0, 0, 0, 0, 0, 0, 0, 0, 0, 0, 0 ]
  ],

  "height" : 840,
  "width" : 1190,

  "checkpointsOrder" : [3, 2, 0, 1],

  "carsStartingPositions" : [[500.0, -140.0, 0.0], [500.5, -180.0, 0.0], [480.0, -180.0, 0]],

  "grandstandsData" : [[400.0, 0.0, false, true]]

}