{
  "tiles": [
    [ 0, 0, 0, 0, 0, 0, 0, 0, 0, 0, 0, 0, 0, 0, 0, 0, 0, 0, 0, 0, 0, 0, 0, 0, 0, 0, 0, 0, 0 ],
    [ 0, 0, 0, 0, 0, 0, 0, 0, 0, 0, 0, 0, 0, 0, 0, 0, 0, 0, 0, 0, 0, 0, 0, 0, 0, 0, 0, 0, 0 ],
    [ 0, 0, 0, 0, 0, 0, 0, 0, 0, 0, 0, 0, 0, 0, 0, 0, 0, 0, 0, 0, 0, 0, 0, 0, 0, 0, 0, 0, 0 ],
    [ 0, 0, 0, 0, 0, 0, 0, 0, 0, 0, 0, 0, 0, 0, 0, 0, 0, 0, 0, 0, 0, 0, 0, 0, 0, 0, 0, 0, 0 ],
    [ 0, 0, 0, 0, 0, 0, 0, 0, 0, 0, 0, 0, 0, 0, 0, 0, 0, 0, 0, 0, 0, 0, 0, 0, 0, 0, 0, 0, 0 ],
    [ 0, 0, 0, 0, 0, 0, 0, 0, 0, 0, 0, 0, 0, 2, 6, 6, 6, 6, 4, 0, 2, 6, 6, 4, 0, 0, 0, 0, 0 ],
    [ 0, 0, 0, 0, 0, 0, 0, 0, 0, 0, 0, 0, 0, 7, 0, 0, 0, 0, 8, 0, 7, 0, 0, 8, 0, 0, 0, 0, 0 ],
    [ 0, 0, 0, 0, 0, 2, 6, 6, 4, 0, 0, 0, 0, 7, 0, 0, 0, 0, 8, 0, 7, 0, 0, 8, 0, 0, 0, 0, 0 ],
    [ 0, 0, 0, 0, 0, 7, 0, 0, 8, 0, 0, 0, 0, 7, 0, 0, 0, 0, 8, 0, 1, 4, 0, 8, 0, 0, 0, 0, 0 ],
    [ 0, 0, 0, 0, 0, 7, 0, 0, 8, 0, 0, 0, 0, 1, 5, 4, 0, 0, 8, 0, 0, 7, 0, 8, 0, 0, 0, 0, 0 ],
    [ 0, 0, 0, 0, 0, 7, 0, 0, 8, 0, 0, 0, 0, 0, 0, 7, 0, 0, 8, 0, 0, 7, 0, 8, 0, 0, 0, 0, 0 ],
    [ 0, 0, 0, 0, 0, 7, 0, 0, 8, 0, 0, 0, 0, 0, 0, 7, 0, 0, 1, 6, 6, 3, 0, 8, 0, 0, 0, 0, 0 ],
    [ 0, 0, 0, 0, 0, 7, 0, 0, 1, 6, 6, 4, 0, 0, 0, 7, 0, 0, 0, 0, 0, 0, 0, 8, 0, 0, 0, 0, 0 ],
    [ 0, 0, 0, 0, 0, 7, 0, 0, 0, 0, 0, 8, 0, 0, 0, 7, 0, 0, 0, 0, 0, 0, 0, 13, 0, 0, 0, 0, 0 ],
    [ 0, 0, 0, 0, 0, 1, 4, 0, 0, 0, 0, 8, 0, 0, 0, 7, 0, 0, 0, 0, 0, 0, 0, 14, 0, 0, 0, 0, 0 ],
    [ 0, 0, 0, 0, 0, 0, 7, 0, 0, 0, 0, 1, 6, 6, 6, 3, 0, 0, 0, 0, 0, 0, 0, 8, 0, 0, 0, 0, 0 ],
    [ 0, 0, 0, 0, 0, 0, 7, 0, 0, 0, 0, 0, 0, 0, 0, 0, 2, 5, 4, 0, 0, 0, 0, 8, 0, 0, 0, 0, 0 ],
    [ 0, 0, 0, 0, 0, 0, 1, 5, 4, 0, 0, 0, 0, 0, 0, 0, 8, 0, 7, 0, 0, 0, 0, 8, 0, 0, 0, 0, 0 ],
    [ 0, 0, 0, 0, 0, 0, 0, 0, 7, 0, 0, 0, 2, 5, 5, 5, 3, 0, 7, 0, 0, 0, 0, 8, 0, 0, 0, 0, 0 ],
    [ 0, 0, 0, 0, 0, 0, 0, 0, 7, 0, 0, 0, 8, 0, 0, 0, 0, 0, 1, 5, 5, 5, 5, 3, 0, 0, 0, 0, 0 ],
    [ 0, 0, 0, 0, 0, 0, 0, 0, 1, 5, 5, 5, 3, 0, 0, 0, 0, 0, 0, 0, 0, 0, 0, 0, 0, 0, 0, 0, 0 ],
    [ 0, 0, 0, 0, 0, 0, 0, 0, 0, 0, 0, 0, 0, 0, 0, 0, 0, 0, 0, 0, 0, 0, 0, 0, 0, 0, 0, 0, 0 ],
    [ 0, 0, 0, 0, 0, 0, 0, 0, 0, 0, 0, 0, 0, 0, 0, 0, 0, 0, 0, 0, 0, 0, 0, 0, 0, 0, 0, 0, 0 ],
    [ 0, 0, 0, 0, 0, 0, 0, 0, 0, 0, 0, 0, 0, 0, 0, 0, 0, 0, 0, 0, 0, 0, 0, 0, 0, 0, 0, 0, 0 ],
    [ 0, 0, 0, 0, 0, 0, 0, 0, 0, 0, 0, 0, 0, 0, 0, 0, 0, 0, 0, 0, 0, 0, 0, 0, 0, 0, 0, 0, 0 ]
  ],

  "height" : 1750,
  "width" : 2030,

  "carsStartingPositions" : [[641.5, 94.0, 0.0], [618.5, 85.0, 0.0], [641.5, 72.0, 0.0], [618.5, 62.0, 0.0],
   [641.5, 51.0, 0.0], [618.5, 42.0, 0.0]],

  "grandstandsData" : [[525.0, 300.0, false, true], [410, 385, true, true], [215, 175, true, true],
   [4, 520, true, false], [-286, 660, true, false], [-460, 236, false, false]],

  "checkpointsOrder" : [0]

}
