{
  "tiles": [
    [ 0, 0, 0, 0, 0, 0, 0, 0, 0, 0, 0, 0, 0, 0, 0, 0, 0, 0, 0 ],
    [ 0, 0, 2, 9, 5, 5, 5, 5, 5, 5, 5, 5, 5, 5, 5, 5, 4, 0, 0 ],
    [ 0, 0, 7, 0, 0, 0, 0, 0, 0, 0, 0, 0, 0, 0, 0, 0, 7, 0, 0 ],
    [ 0, 0, 7, 0, 0, 0, 0, 0, 0, 0, 0, 0, 0, 0, 0, 0, 7, 0, 0 ],
    [ 0, 0, 7, 0, 0, 0, 0, 0, 0, 0, 0, 0, 0, 0, 0, 0, 7, 0, 0 ],
    [ 0, 0, 7, 0, 0, 0, 0, 0, 0, 0, 0, 0, 0, 0, 0, 0, 7, 0, 0 ],
    [ 0, 0, 7, 0, 0, 0, 0, 0, 0, 0, 0, 0, 0, 0, 0, 0, 7, 0, 0 ],
    [ 0, 0, 7, 0, 0, 0, 0, 0, 0, 0, 0, 0, 0, 0, 0, 0, 7, 0, 0 ],
    [ 0, 0, 7, 0, 0, 0, 0, 0, 0, 0, 0, 0, 0, 0, 0, 0, 10, 0, 0 ],
    [ 0, 0, 10, 0, 0, 0, 0, 0, 0, 0, 0, 0, 0, 0, 0, 0, 7, 0, 0 ],
    [ 0, 0, 1, 5, 9, 5, 5, 5, 5, 5, 5, 5, 5, 5, 5, 5, 3, 0, 0 ],
    [ 0, 0, 0, 0, 0, 0, 0, 0, 0, 0, 0, 0, 0, 0, 0, 0, 0, 0, 0 ]
  ],

  "height" : 600,
  "width" : 950,

  "checkpointsOrder" : [3, 2, 0, 1],

  "carsStartingPositions" : [[-357.5, -180.0, 0.0],[-340.0, -200.0, 0]]
}